1 1 1 1 1 1 1 1 1 1 1 1 1 1 1 1 1 1 1 1 1 1 1 1 1 1 1 1 1 1 1 1 1 1 1 1 1 1 1 1
1 0 0 3 0 2 0 4 0 0 4 0 6 6 6 0 0 6 0 7 0 7 0 0 0 0 0 7 0 0 0 0 0 0 0 2 0 0 5 1
1 0 0 3 0 2 0 4 4 4 4 0 0 0 0 6 6 0 0 7 7 7 0 7 7 7 0 0 0 0 2 0 2 0 2 0 0 0 5 1
1 0 0 0 0 2 0 0 0 0 4 0 0 0 0 0 6 0 0 0 0 7 0 0 0 7 0 7 0 0 0 0 0 0 0 0 0 0 5 1
1 0 0 3 0 0 0 4 4 0 0 0 6 0 0 0 0 6 0 7 0 7 7 7 0 7 0 7 0 0 2 0 2 0 2 0 0 0 5 1
1 0 0 3 0 2 0 0 4 4 4 0 6 0 0 6 0 0 0 7 0 0 0 0 0 7 0 7 0 0 0 0 0 0 0 2 0 0 5 1
1 1 1 1 1 1 1 1 1 1 1 1 1 1 1 1 1 1 1 1 1 1 1 1 1 1 1 1 1 1 1 1 1 1 1 1 1 1 1 1